F 220,100,0

NO ./path_to_the_north_texture.xpm
SO ./path_to_the_south_texture.xpm
WE ./path_to_the_west_texture.xpm
EA ./path_to_the_east_texture.xpm

C 225, 30,0


11111111111111111111111111
11S00000100011111111111111
11010100100011111111111111
11000001 10011111111111111
11000000100011111111111111
11010100000011111111111111
111011110001111111111111111
1011110100011111111111111
1111111111111111111111111