NO textures/m1.xpm

DR textures/door.xpm 
SO textures/m2.xpm
WE textures/m3.xpm
EA textures/m4.xpm

F 155,155,155
C 176,224,230

        1111111111111111111111111
        1000000000110000000000001
        1011000001110000000000001
        1011000000200000000000001
111111111011000001110000000000001
100000000011000001110111112111111
11110111111111011100000010001
11112111111111211101010010001
11000000110101011100000010001
10000000000000001100000010001
10000000000000001101010010001
11000001110101011111011110N0111
11110111 1110101 101111010001
11111111 1111111 111111111111