F 115, 115, 115
                   
NO textures/m1.xpm
SO textures/m2.xpm
WE textures/m3.xpm
EA textures/m4.xpm
    
C 36, 113, 163

11111
1N001
11111