
NO textures/m1.xpm

SO textures/m2.xpm
WE textures/m3.xpm
EA textures/m4.xpm
C 155,100,160
F 111,111,111

1111111
100N001
1111111
