
NO textures/m1.xpm

SO textures/m2.xpm
WE textures/m3.xpm
EA textures/m4.xpm
C 155,100,160
F 111,111,111

        1111111111111111111111111
        1000000000110000000000001
        1011000001110000000000001
        1001000000000000000000001
111111111011000001110000000000001
100000000011000001110111110111111
11110111111111011100000010001
11110111111111011101010010001
11000000110101011100000010001
10000000000000001100000010001
10000000000000001101010010001
110000011101010111110111100111
11110111 1110101 101111010N01
11111111 1111111 111111111111