F 220,100,0

NO ./path_to_the_north_texture.xpm
SO ./path_to_the_south_texture.xpm
WE ./path_to_the_west_texture.xpm
EA ./path_to_the_east_texture.xpm

C 225, 30,0


1111111111111
1100000010001
1101010010001
11000001 1001
1100000010001
1101010000001
111011110N0111
101111010001
111111111111