NO ./path_to_the_north_texture.xpm
SO ./path_to_the_south_texture.xpm
WE ./path_to_the_west_texture.xpm
EA ./path_to_the_east_texture.xpm


F 220,100,0
C 225,30,0





        111111111       11111111111111
        1000000001      10000000000001
       110110000011     10000000000001
      11100100000011    10000000000011
111111111011000001111   11110000000011
10000000001100000111011   1111111111
111101111111110111000001
11110111 0 11110111010101
1100000111110101110000001
1000000000000000110000001
10000000000000001101010N1
1100000111010101111101111111
11110111 1110101  10111101001
111111111 1111111 11111111111
