F 220,100,0

NO /1.xpm

SO /2.xpm
WE /3.xpm
EA /4.xpm

C 225, 30,00000


11111111111111111111111111
11000000100011111111111111
11010100100011111111111111
11000001 10011111111111111
11000000100011111111111111
11010100000011111111111111
111011110W01111111111111111
1011110100011111111111111
1111111111111111111111111