NO ./path_to_the_north_texture.xpm

SO ./path_to_the_south_texture.xpm

WE ./path_to_the_west_texture.xpm

EA ./path_to_the_east_texture.xpm


F 220 ,100 ,250

C 225,30,0

   1111
100001
10110001
1001

1000111
110111
1N0001
1111111